}{}{^^^^^^.a<<<<<<c....
{}{}%%%%%%.>122223>..@.
}{}{yyyyyy.>455556>..b.
{}{}luquMj.>788889>....
/\/\LUQUWJ.A<<<<.<C.@..
()T...B._...p..@.....B.
/\..p..___.....b_..p...
_______________________
()()....__..__.b..__...
/\/\()..__..@...().....
...b/\..__@.B.../\@..p.
()..B..b__.....@.B..().
/\()..()__...()...../\.
B./\../\__.b./\...B....