------------
............
............
............
............
............
............
............
............
............
............
____________