...()..jjjjjjjjjjj().m.
.../\()kkkkkkkkkkk/\.()
().../\KKKKKKKKKKK.../\
/\.()..lggdglgeggl()().
.../\()lggiglgiggl/\/\.
.()../\LGGIGLGIGGLab.mc
./\...............AB..C
_______________________
.......................
.......................
.......................
.......................
.......................
.......................