}{}{^^^^^^B...().().
{}{}%%%%%%B.../\./\..
}{}{yyyyyyB.........
{}{}luquMjB.......()
/\/\LUQUWJB......./\
..T....._...........
........_......._...
____________________
..__........__....__
...@........@.......
..........@.......@.
....@..........@....