}{}{^^^^^^B...().()......
{}{}%%%%%%B.../\./\......
}{}{yyyyyyB..............
{}{}luquMjB.......().....
/\/\LUQUWJB......./\.....
..T....._................
.......___......_........
_________________________
..__........__....__.....
...@........@............
..........@.......@......
....@..........@.........