b.......__a()()()()
...a()..__(}{}{}{}{
..../\..__/{}{}{}{}
.a....a.__(}{}{}{}{
....b...__/{}{}{}{}
.()....f__(}{}{}{}{
d/\....F__/\/\/\/\/
___________________
()..a...__...b....a
/\()()..__......e..
d./\/\d.__.g.()..b.
...a...a__..G/\....