{}{}{}{}{}{}{}{}{}{
}{}{}{}{}{}{}{}{}{}
{}{}{}{}{}{}{}{}{}{
/\/\/\/\/\/\/\/\/\/
()a..b.....a..d...b
/\....()........c..
()d.../\..a_..b.e..
/\........_________
()............__.()
/\..c....b.....e./\
()..........()..a..
/\d...b...../\d..b.