______________
____________ee
___aChddfFFDEE
___A________g_
___A__________
i__c_________i
I____________I
______bb______