{}{}{}\.__..()a....
}{}{}{).__../\...b.
{}{}{}\b____....d..
}{}{}{).__.__.a.().
{}{}{}\.__..__.d/\.
}{}{}{)a__.b.__....
{}{}{}\.__...._____
}{}{}{).__.a...____
{}{}{}\.__......b..
/\/\/\d.__...a()...
.....d..__..../\...
..a.....__..b....a.